>Rosalind_4436
GTACGTAACACATACCATCCCGTACAGCCGCGCACATTTGTATAAACTGTTCTAGTACCC
TACAGGATGTTTCATTACTTTTCGCGGGTACTAGTAATGTTTGGCACAAATTCCAGTGCT
GAGTACTCTATACCAACCCCCTACTGGCCCTAGGTTAAAGGTAAACACGGCTCCGATCCG
CCAAACCGTCGTAGGAGGCAGTGGAGCGCAATTCGATCGGCCGTGCAGATACAACCGTAC
CGTCTGATGTAATGCTAGGGCTGACGTCATCAAGCTTTGCAAGCCGCCACCATGAACCTC
AGGTTGATCAAACTCGTCAGATTCCGACTATACGGTACGTATCAGAGCTCACCCGCGATT
AGCGGCAGAACCATCTTATGTTATTCACGGAATATATTGTGCTCACAATGAGTAAGGACT
TGGTACAGTCAGCCCACATGCCTGATAGTCTTGGCAAAGCTGGTACGTAGTCAATGAAGG
CCTTAGAGACTGCGGAATGTCCTGACGGCGGTGATTTAGGTCGGCGGTCCAACGGCCAAC
GAACCCTCTCAACACTGTCGCCTAATGTGGTCATTAGTTTACGACACACACAGATAGACC
TGCTCTAGTCAAAATCTGCATGGTGTGTAGCTTACGGGGGGCTGAAGGGGGCATTACTTG
TTATGGAAGTCGCCTAAGGAAACGTGTACTCCGTGCCAGAGCAGGCTAACGAGCCCTGAA
ATTCATCCGACCTAACGCGAGGGATATGCCGGGCTCCTTGTGGGGGTGGCATGTCTCCAA
AATAAAATACTCGATTCTGCTGGAGTGTGGGTCAACTTTGTGGGCTCCTGGTGCTATTTA
GGATATTCGTGCCCTGCCGAACCCACCGTAATCCTACGAGATCGTGCCCCGTGAACGACT
TTACCCAGGGTTGCACCCAAG
>Rosalind_9418
CAGCTTTCTTCGCACTGAGCAATTAAAAAACGGAGGTTCTCCCTGATGGATAGAGCGAAA
GCGTGACTTGTTCGCCCAACGCGACTGCGTATTGACTCGGCTGTCATAACATCCACAAGA
AAGAGACGAGTGGAAATCTAGGTGGTGCATCAAACCGTGGAACCAGGATGGCATGCGGCT
CCGCCCTGGGGGATCTGTCCTCCTTGCTCGCGAGCGAGATAATTGTGACCCGATGGCAGA
TGTTCAGGGAGACTCCACCTTCCAGCTCGGCGTAACAGGCCTGTAAATCGGTAAGTCTTC
AACTTGGAGTAAAAGGGGGGTGCTCACCTAGCGCGCGGGCAAGTGCTGCAGAAACCCAAC
TCAGCAGGACACGCGTTAAAAACGCACAATCCTCCGGGGCAGAACGATAAGAATGGTGGC
CTGCCTTACTATTACCTATTGGGGTTGTAGGCGACCGATCCACTCTGCCCGTAGAGGTAC
GTCATGGGTCAAGTATGATATTGCTCCCCCTAAGCGGCGCGTTCTAGCATAACCGGTACC
GGATCTGACTCGTTCTGACTCCTCTAATTCAGTTATCAACTAGTTGGGCCCAGCGGTTTC
GATTCGAACGACAGGGGGAGTTACATGCGGGCCAACGCTGGCGTATAGGGGGTTACTCTC
CCCCCTAGAACTAGGATATGGCCCAATAGGCCATAACCACACACCCCACGTTCGACGAGA
TGGGGGAGCTTGTTCTTCGTGAGGTGAGGTTGGGAAATGCCATTATTTATAGGTCCTGAT
TCCGCACGAACTGGGTGAGCCATTCATAAGCGCTGGCAGATGTAGCTGTGTCTCTCA
>Rosalind_9633
CCTAGTGCCGTCACGAAGATAATCGCCGTCCTGCGCCGGATGGTCGGCAGGGCGAACCAA
AGCCTGCCGACGTGCAACCTTCGTCATACACGCCCACAGTGTATAAACCGCCTAACTCGT
AATGGGTCAATACGCCCGTAAGGCGTTAAGGCCTGCCCCGAAAGGAAGATTTGCCAACTT
ATTGGCGCGCCGCGTTCAGTAGCTATGTTCCAGTCTTTTCGCAAGTTTTTCACTTCTCCA
CCGTCGACACGGCGACGGCAATATGGGTGGTATACTTCATGGGCCGTATTTCCGGCGTGG
TCAGTAATAGGTTCCTACAAGTTCTTTGGGGACATCCATTAGTGATGATCAGAAACTAAG
GATCACATACGGACCTCTCCAACGCAGCAAAGTCTTGTCTACGACGGACAACTAGCCGAT
ATAACATTGGCGAGCCCTCAACTCCGAAGAGTTCCGGCGCACTTATCTGCCGGTAACCTA
TTGTACGGGATAGTATGTATCACAACCCCAGAAGCCATTGGGTGTTCAGCGGGAGCCCAA
GGCGCGACGAAATACTTCTTAGTCGTCTTTTTTTGTGTAATACGAGTGTGCAGATTATTC
AGAGACATTTCGCGGCTCACCTTTAATAAGGGTTTGATCGCAAATACGAAACCTGTTTAT
GCATCCGAATGACTTGTGTAGGTGGATGGAGGAAAAGGAGCAAAACACCCTGTGGCACCG
CCCCTGCAAAATAGGAGCCCTACTGGCTGAAGTTCCACTTCGCTCAGAGCTACGTGATTG
TACCGCACAGAATTATTACAAGCTCAGTGCTTTTGCAAGATGTACTATACATAATAAGAA
GTGACTACCTGCATTGCGGGTGCAGATGAGAATTGCAGTATACGATGCGTC
>Rosalind_4959
TCCGAATTGGTCAGTCGTGCATGGTTTTAGAGGCGAAGGTTAACAGGGTTCAAAGGTAAT
TTCATCTCGAAGGTAGTTATCCCACCTCCTCCCCAGCCGAGCTAGCGAATGCCAAGGTGG
CTAAAAATCATCCGGCAGACCCGATGATAGACATTGTCACGTTATTCCCTCACTTTATAA
AGCCTCGACTGTTAAGAGCAACGTGGGTATTTTTTTGACTGGGCAGTAATTTGGGCGAAA
AGAAACAAGACAAACAACGAAATCTGCCTAAAAATGGAACCACCGGCATGACAAAGGATT
ATTAAAGGCGACTATAGACGCCTTCATTTCCGATAGTACGGCAGCATGTCTGAGGCTCTA
TTGAGCGGCGTGTGATAGACAGGTCAATGGGATTAAATCGTCAGCTAGCTAGGGGCCTTC
TCTATCCCGGGAGCATAAGCAACTGTGAGTGGGACCGCGGTGTCTTGCGCCGCTTTCATA
GGGGTATCCAAGACACTGTGAACGAAAAATACGATCTACCTGTCTACAGAGAACTCATGG
ACCGCAAAGATACCTTATATAACGGACTAACCTGTCGCGAAGCTAGTCCTGGCTATACAA
CCTGTTATTCACGTAGGGGTGCTACACAGTACGGTTAGGTACCGGGGGATACTGTGATAG
CAAGATTAGAGTCTGCTTGCAGTTGCGATACTACAATTTGCAAGCTCGTCATCCAGGCGC
TCCCCGAGTGCAGGCGCCTGGAGTTGGCTCTGTTATTATATGGCGTTCTGGACAAATCGA
AGCGGTTTTTGACGCGGTTTCCATTCGATCCTAGAGAGTGGCAGGCGGGGAGGGGTCGAG
ACTAGAAGGTCGATATGGGCTAGATCTACTACCCTGAAATACAGTGCTTTTAATAGCGTT
CGATGCTACACCCAAACATGACGCCGAAATTCATGACATGCAGCCTCGTCTCGACTCCTC
TCGCCCCAATGGCCGGTGTAAGAAATCTTAT
>Rosalind_1790
TATAGGATGGTCCGACTAAGCGTCTAGGTTTTTGTCGGACAGCTACGCTTACCCTCACCG
CTACGCAGCGTTATCCCGATTAATGCCATTAATAGCTACCAATGTCCTGCCTGGGGGACT
GTCCCTTGCCTTCAGCCTGTACGGGACTAGCCGATACTCAGTGTTGGAGAGATTGTAATG
GACTTAACCCCGAGAATTAGCTACGCATCCCCTGCTTACTATCACAAATGTGCTACGTTT
CCTTAGTTCACATGACTCTATTAGGATCTAAGATTAAGGCACCCTAGAACTGCCTGGTCC
TCTGTTTAAAATACTTTTCGGAGGGACGCATCCCGCATTCCTAGGCAATACGGATGTTTG
ATACCGACGCCGGCAAAATCGGTGTAAGTCGACAAAATATGCCTAGCAAGCTCGAGCTCG
TGCTATATAATAATCAGGTGGTGTCAAGGGTTTTGTCTGGGCATATCTCCACAGGTATAT
ACACCGGTGGTGCCTACCAAGAACTCTAGGATGCGTGTTCGCCGACACGAACACGGGAGT
CCGCGACTTGCGGGAATTGTTGCCTAAGCATAGCCCTCTGTATTTCAGCCGCGATTATCG
ATCGAGAGGTGTGAATAGATGGATGGTCTACCAGGAGAGCGGTCCGCAGTCGCGTAGTCA
GTAAGCAGAGTAGCCAACGTCCGCGCGAGAAATGGGGTAACAGGTTCTGACGAACTTATG
CTTGAAATCATCGAGCAAGAGAGTGTTAGCGCGTGGTAGGGTGGGCTCGGAATATGGCTG
TATCGACGTGATTTATTCATCATGCGAATAGCTGCACCCGGACAGGGGAGTTCACCCTCC
AGATTACCGTAGCGGCCAAAACTGGCCACCGGCAACCTCACCCGAATCCCCTACCTTACG
AGATAGCTTTGTGTCAGTCAAT
>Rosalind_5953
CTTCCCGATAACAATAAGAAAGGCCCTCTACGAGGCAAGGTCATATCCAGATTATGGATC
TGGGTTCGGTCTTAAAGAATGCTCCCGGCAACCGGTGGGACAGGCGGCTCCGGATCTGAT
CGCAGGCTTTTTAAGTCCGCACTGAATACACATCAGAGCGGAGAAGCAGAACACAGTCAG
GTGGATGAATGATTAAGGAGTGCCACGTATCCGCAACAATCCAGTTGTACTTTGGGGTGA
GTTAGTACGCTCTCCGGTATAGTCCTAGGACATGAACTCCTGGGGCGAGGTAACAACAGA
TGAGTCCGTATAGGTCGCTACTCAACAACGTGAGTACACCTTCTCAATAGACGGTCCTTT
GAGGCCACCCGCAGCACTTTACGGGTCGAGGGCGGCTCCCAGCTGCTGCTTGTAAACGTT
CGGATTGTGGAGATGCGCGTTCGGTCAAAGTCACGTGCCCCTTGGCGGTCCGGACCCACA
ATAATGAAGCGATCCGAGGAGTAAATGAACTGTCTGCGAGTAATCGGGAGCCCACTAAAG
CTGCATTTAATAATCCAGAAAAACATGTTACTGGAGATAGTGTCCGGGTACGCAGCAAAG
CGCTCAAGGATATGTCCATACTGGCGAAATTCCATGCCCACAGAACGGCGGGTAAAAGGT
GGAGTCGGACCCCCTGCCGGTCACAATAAGTCGCGCGGGCGTCATAATCATTGCTCTCGT
GATTGATAGGCCACTAGATGAGCAAGCAACTTATAACTTATGCTTGTCCAGGAAGCCGCC
GGACGCCAGCGTATGCCAATTCATGAAACAGTCGCGCTGCTCCA
>Rosalind_2695
GGTCATGCGATACGGCGTGAAAGAGCATCCTCAGCGATTGCAGCACCTAGAGACCTTTGG
GTCGTATGTTAGCACGACCGGCAGTCATGATGTTGCGTATTCTTGCTGCGTATGTTGTCG
CGCAGAGGCCCCTGTCTGCTAAAAACGACCCCGTAATTACTTCTCACCTAGGTGGTCAAT
TACATCCTTGATGCCGTGGTATCCGGAAAGGATCGACAAAGGTTTGATTCTCAGCCAGCG
GACAAAGAATGGAGCTAGCAGTCCCGTGAAGTCTCGTATAGGAGATAGTAGAACATCTAC
CCTCGGCTAAGGAACGAGACATTGGCGTTTTAGCTGGGCTATGGCCTGATATACGTAACT
GGGGCCGATAACTTCCCGCCCGTTGCCCCCCACTCCTCTATCGTAAGGCCTAGTCCATAT
TACTAAGAGACATTCAAATTCCCTGTACTATATCTAGAATCAAATCCGGCGTGTCTTCGT
CGGACATAAGGCAACGTCTTCAGTTGTGCTAAGAGACGCGGAAGCCTGCGGAAGCAAACT
ATGTGTAAGAGCAGGAATGTAACAACTCAAGGCCTCTAACAATGATCACTATGTGGTTAC
CCTCTATCCCCGTCTGAGCGCACCATGGTCCAATTTCGTTTTGCCCCCGTTCGTGGGAAG
GTGGGCAACTCGGATTGGCCCTGATTAGTTTAGATAACTTAAGAGCGCAATCGTGCTGCG
GAGGTCCACATAAGCATTATATCGATCCGGAATAGTAACGTCAAAAGAGATGGCGCCCCG
ACAGCCCGCCGCTACACGACGTAGGGAGGCAAACCGTTATCCGGCGACGTCTATTGGTTA
GTCCCTCGAGAAAAAGAGCTAGGAGTACATCGAGAGTGTGCGCGGAACAGAAGAGCAAGC
CGGATTGCTTCGCGTTGCTGTGACGCACCCGAGATGTTTACGCGTAAATG
>Rosalind_7194
GAGGCGCGCTTAACACAGGATACCAAGCGAGTGTTTGCGACTGAGCTCTCGTAGAGCCGC
CCAACCAGGACCTATTCGCTTAAGTTGCGGTTGACCAATAGTCAGGGCGGAGGGATGCCT
CTATCCTGATATGATACTCGAGGCGAGTGCAGACGGGTCGAGATGGGGAGACCTTTTCTC
TTATGTGGCGACCTCGTCGGTGATGAGAGACCCAATCAATGCACATTCTATCTCTCTACC
TGTCAATGGCTGGTGGAAATCCTCCTGTCCGGGTTGCACGCGTACGCGAGGCGTGTATTG
CCCGCTCATAGCTATCAGGGAGGGCCAGGCAGCTCCCTTTCGACCTCCTCCATACTGACC
GGCAGGTAACCGCCGCAATGCCCTTCCGTACGGATCACTGTGCATGCATTTATTTGGGTA
ACTTAAAGACACAGTCATAACCATGATAGATGGCCAACACGGTGTCGTCCACTACCCGGT
ATATTGATTACAGACATTACCTTGTCGGTCCATCACAACTTGCGGGTTGCCGTGGCAGCG
GTTAAGATAATTGTTGGCACTTCGGGAGTTAGACCCCGGATAGGGCGCACTTTCTCTCAA
GAGTGCCAACGGTAGGTAGTTGGGGTGCTTAACCACGGGGTTGACCTCGTCTCGCCAGAT
TTAAGGAGTTGCCTCCAATAGCATGGCGGGTATAGGGGACGCATGTATTCGACGGCAAAG
GGCTATAATTACTATCCCGGCTTAGTACAACAGACGATTGATAGAAACTGACTCTCCTAG
TATAACAATGGACGTCGGGGTTTGGCGTATATTTATTTCCTCGTGCGCTTCAGAACGCAG
ATCAGCACATTGACAATCGCGGTCGCACCGTTTCAACAGCTAACGCGCGTGCTACGAGGC
GATTTTAGTTGGAAAATCCTCTGTGTAGGGGATGTAACAACGGCTCCTTTTAGTTGTGGG
ACCGGCACGATGTCGAGAAGCAGGACCC
